                                                   
                                                   
################################################   
                                               #   
                                               #   
                                               #   
                     #############             #   
                                 #             #   
                                 #             #   
                                 #             #   
                                 #             #   
                                 #             #   
   ###############################             #   
   #                                           #   
   #                                           #   
   #                                           #   
   #     ############        ###############   #   
   #     #          #        #             #   #   
   #     #          #        #             #   #   
   #     #          ##########             #   #   
   #######                                 #   #   
                                           #   #   
      ######################################   #   
      #                                        #   
      #                                        #   
      #             ########################   #   
      #             #                      #   #   
      #             #                      #   #   
      #             #       #########      #   #   
      #             #       #       #      #   #   
      #             #       #       #      #   #   
      ###############       #       #      #   #   
                            #       #      #   #   
                            #       #      #   #   
  ####  #####################       #      #   #   
  #  #  #                           #      #   #   
  #  #  #                           ########   #   
  #  ####                                      #   
  #                                            #   
  ###########################################  #   
                                            #  #   
                                            #  #   
  ###########################################  #   
  #                                            #   
  #                                            #   
  #                                            #   
  #                                            #   
  ##############################################   
                                                   
                                                   